1111111111
10E0C10011
10C010CC01
1000C1P011
11100C0001
1111111111